25 20
#############
#...........#    ########################
#...s...s...######......#...............#
#..S....................................#
#...........######......................#
#.....s.....#    #......#...............#
#...........#    #......#...............#
#...........#    #......#...............#
#####..######    ###..###################
    #..#           #..#
    #..#           #..#
    #..#          ##..##
  ###..####      #......#
  #..@....#      #......#
  #.......#      #......#
  #.......#      #......#
  #.......#      #......#
  #.......#      #......#
  #.......#      #......#
  #########       ######
